|-|+-|/|-+-|+|-|
i           *  |
+  +-|/|-+  +  +
|  |     |     /
+  +-|+  |-|-  +
|     |     |  -
||-+  +--+  +  +
|     |  |     |
+  +--+  +  +**|
|        |     g 
|-|/--+|-+||+**|
