-i-|---  +--+--+
|     |  |     |
+  -  +--+  +**-
|  |        |  g
*  +-*-*--  +  *
*           |  *
+  |  -|-+--+  +
|  |  |        |
-  |--|  |--+  +
|           |  |
-++/++/++/++---+
