+i-+|-|--+-|+--+
|     |        |
+  +--+ +---+  +
|  |        |  |
-  -*-*-*-  +  +
|           |  |
|+/+-|-|-+--+  +
|              |
*  +--+--+  ++/+
g  |           |
-**+--+--*-*|-+-
